######
#P#O #
###  #
#   X#
######
